0 0 0 0 0 0 0 0 0 0 0 0 0 0 0 0 0 0 0 0 0 0 0 0 0 0 0 0 0 0 0 0 0 0 0 0 0 0 0 0 0 0 0 0 0 0 0 0 0 0 
0 0 0 0 0 0 0 0 0 0 0 0 0 0 0 0 0 0 0 0 0 0 0 0 0 0 0 0 0 0 0 0 0 0 0 0 0 0 0 0 0 0 0 0 0 0 0 0 0 0 
0 0 0 0 0 0 0 0 0 0 0 0 0 0 0 0 0 0 0 0 0 0 0 10 8 8 8 8 8 8 8 9 0 0 0 0 0 0 0 0 10 8 8 9 9 0 0 0 0 0 
0 0 0 0 0 0 0 0 0 0 0 0 0 0 0 0 0 0 0 0 0 0 0 11 7 82 81 7 77 7 7 4 10 8 8 9 8 8 8 8 11 7 77 7 4 0 0 0 0 0 
0 0 0 0 0 0 0 84 0 0 0 0 0 0 0 0 0 0 0 84 0 0 0 11 7 83 80 7 7 7 86 5 29 31 31 29 31 31 31 31 31 31 30 30 4 0 0 0 84 0 
0 0 0 0 0 0 0 0 0 0 0 10 9 9 9 9 9 0 0 0 0 0 9 11 7 7 7 7 7 7 7 7 7 7 7 7 7 7 7 7 7 7 7 5 4 8 8 9 0 0 
0 0 0 0 0 0 0 0 0 0 0 6 77 7 7 7 4 8 8 8 8 8 11 77 7 32 39 39 39 39 39 39 39 39 39 39 39 39 39 39 39 38 27 5 30 7 7 4 0 84 
0 0 0 0 84 0 0 0 0 0 10 6 7 7 7 7 7 7 7 7 7 7 7 7 7 36 76 68 68 68 68 68 68 68 68 68 68 68 68 68 75 40 27 7 42 7 77 4 0 0 
0 0 0 0 0 0 0 0 0 0 11 86 7 32 39 39 39 39 39 39 39 39 39 39 39 54 71 70 70 70 70 70 70 70 70 70 70 70 70 70 72 40 27 7 42 7 7 4 0 0 
0 0 0 0 0 0 0 0 84 0 11 7 7 36 41 41 41 41 41 41 41 41 41 41 41 41 71 70 70 70 70 70 70 70 70 70 70 70 70 70 72 40 27 79 42 7 86 4 0 0 
84 0 0 0 0 0 0 0 0 0 11 77 7 36 41 41 41 41 41 41 41 41 41 41 41 41 74 69 69 69 69 69 69 69 69 69 69 69 69 69 73 40 27 78 42 7 7 4 0 0 
0 0 0 84 0 10 8 8 8 9 6 79 7 36 41 41 41 41 41 41 41 66 34 34 34 34 34 34 34 34 34 67 41 41 66 34 34 34 34 34 34 35 27 7 42 7 7 4 0 0 
0 0 84 0 0 11 7 7 7 7 6 78 7 36 41 76 68 68 68 75 41 40 21 22 18 21 22 18 21 22 18 23 12 14 19 18 21 22 18 21 22 23 27 79 42 7 7 4 0 0 
0 0 0 0 0 11 77 7 85 7 6 7 7 36 41 71 70 70 70 72 41 40 20 25 16 20 25 16 20 25 16 24 13 15 17 16 20 25 16 20 25 24 27 78 42 1 1 3 0 0 
0 0 0 0 0 11 7 82 81 7 44 6 7 36 41 71 70 70 70 72 41 40 47 26 26 26 26 26 26 26 26 26 60 59 26 26 26 26 26 26 26 26 28 7 42 0 0 0 0 0 
0 0 0 0 0 11 86 83 80 7 7 6 86 36 41 71 70 70 70 72 41 40 27 79 7 5 1 46 46 46 46 46 37 43 46 46 46 46 46 46 46 46 46 46 45 0 0 0 0 0 
0 0 0 0 0 11 7 7 7 79 7 6 7 36 41 71 70 70 70 72 41 40 27 78 7 5 47 26 26 26 26 26 37 43 26 26 26 26 26 26 26 26 26 4 0 0 0 0 0 84 
0 0 0 0 0 11 77 7 7 78 7 6 7 36 41 74 69 69 69 73 41 40 27 77 7 5 27 7 7 82 81 7 60 59 7 77 7 7 82 81 7 7 79 4 0 0 84 0 0 0 
0 0 0 0 0 11 7 7 7 7 7 6 7 36 41 41 41 41 41 41 41 40 27 7 85 5 27 7 7 83 80 7 60 59 7 7 7 7 83 80 7 7 78 4 0 0 0 0 0 0 
0 0 0 0 0 11 7 7 77 85 7 6 77 33 34 34 34 34 34 34 34 35 27 7 7 5 27 7 77 7 7 7 60 65 58 58 58 58 58 58 58 61 7 4 0 0 0 0 0 0 
0 0 0 0 0 11 7 7 7 7 7 6 7 19 21 22 18 18 18 21 22 18 27 79 7 5 27 7 7 7 7 7 63 57 57 57 57 57 57 57 65 59 7 4 0 0 0 0 0 0 
0 0 84 0 0 11 85 7 7 79 7 6 7 17 20 25 16 16 16 20 25 16 27 78 7 5 27 7 7 7 7 7 7 7 7 7 7 7 7 86 60 59 7 4 0 0 0 0 0 0 
0 0 0 0 0 11 7 7 7 78 7 6 7 26 26 26 26 26 26 26 26 26 28 7 7 5 27 7 79 5 1 1 1 1 1 1 1 1 6 7 60 59 7 4 0 0 0 0 84 0 
0 0 0 0 0 2 1 1 6 86 7 46 46 1 46 6 7 77 7 7 5 46 46 46 46 46 27 7 78 4 0 0 0 0 0 84 0 0 2 1 37 43 1 3 0 0 0 0 0 0 
0 0 0 0 0 0 0 0 11 7 7 26 26 26 26 46 46 46 46 46 46 47 26 26 26 26 28 7 7 4 0 84 0 0 0 0 0 0 0 0 37 43 0 84 0 0 0 0 0 0 
0 0 0 0 0 0 0 0 11 82 81 7 86 7 7 26 26 26 26 26 26 28 77 5 1 1 1 1 1 3 0 0 0 0 10 8 8 8 8 9 37 43 10 8 8 9 0 0 0 0 
0 0 0 0 0 0 0 0 11 83 80 7 7 7 7 7 7 7 7 7 7 7 7 4 0 0 0 0 0 0 0 0 0 0 11 7 7 77 7 7 37 43 7 7 7 4 0 0 0 0 
0 0 84 0 0 0 0 0 2 1 1 1 1 1 1 1 1 1 1 1 1 1 1 3 0 0 0 0 10 8 8 8 8 9 11 7 7 7 7 7 37 43 7 7 77 4 0 0 0 0 
0 0 0 0 0 0 0 0 0 0 0 0 0 0 0 0 0 0 0 0 0 0 0 0 0 0 84 0 11 7 7 7 7 7 6 79 7 7 86 7 60 59 7 7 79 4 0 84 0 0 
0 0 0 10 8 8 8 8 8 8 8 8 8 8 9 0 0 84 84 84 0 0 0 0 0 0 0 0 11 7 77 7 7 7 6 78 7 77 7 7 60 59 7 7 78 4 0 0 0 0 
0 0 0 11 7 86 7 7 7 7 7 7 7 86 4 0 0 0 84 0 0 0 0 0 0 0 0 0 11 7 7 7 29 30 6 7 7 7 7 7 60 59 82 81 7 4 0 0 0 0 
0 0 0 11 77 7 7 77 7 7 7 77 7 7 4 8 8 8 8 8 9 9 8 8 8 8 8 9 11 79 7 7 6 7 7 7 62 58 58 58 65 59 83 80 7 4 0 0 0 0 
0 0 0 11 7 7 79 7 7 79 7 86 82 81 7 77 7 7 7 7 7 7 7 7 7 7 7 7 7 78 7 7 6 7 82 81 60 65 57 57 57 64 7 7 77 4 0 0 0 0 
0 0 0 11 85 7 78 7 7 78 7 7 83 80 7 7 7 7 77 7 7 77 7 82 81 7 7 7 7 7 7 7 6 7 83 80 60 59 7 7 7 7 86 7 7 4 0 0 0 0 
0 0 0 11 7 79 32 39 39 39 39 39 39 39 39 39 39 39 39 38 27 7 7 83 80 7 7 7 7 32 39 39 39 39 39 39 12 14 39 38 27 7 7 7 7 4 0 0 0 0 
0 0 0 11 7 78 36 41 41 41 41 41 41 41 41 41 41 41 41 40 27 7 7 7 7 7 7 77 7 36 41 41 41 41 41 41 41 41 41 40 27 77 7 79 7 4 0 0 0 0 
0 0 0 11 77 7 36 41 41 41 32 39 39 39 39 39 38 41 41 40 27 7 79 7 7 79 7 7 7 36 41 76 68 68 68 68 68 75 41 40 27 7 7 78 7 4 0 0 0 0 
84 0 0 11 7 7 36 41 41 41 36 76 68 68 68 75 40 41 41 40 27 7 78 7 7 78 7 7 7 36 41 71 70 70 70 70 70 72 41 40 27 7 7 7 7 4 0 0 0 0 
0 0 0 11 7 79 36 41 41 41 36 74 69 69 69 73 40 41 41 55 39 39 39 39 39 39 39 39 39 54 41 71 70 70 70 70 70 72 41 40 27 82 81 5 1 3 0 0 0 0 
0 0 0 11 7 78 36 41 41 41 33 67 41 41 66 34 35 41 41 41 41 41 41 41 41 41 41 41 41 41 41 71 70 70 70 70 70 72 41 40 27 83 80 4 0 0 0 0 0 0 
0 0 0 11 85 7 36 41 41 41 19 18 12 14 18 18 23 41 41 41 41 41 41 41 41 41 41 41 41 41 41 74 69 69 69 69 69 73 41 40 27 7 7 4 0 0 0 0 0 0 
0 0 0 11 7 7 36 41 41 41 17 16 13 15 16 16 24 41 41 41 66 34 34 34 34 34 34 34 34 67 41 41 41 41 41 41 41 41 41 40 27 77 7 4 0 0 0 0 0 0 
0 0 0 11 7 79 36 41 41 41 41 41 41 41 41 41 41 41 41 41 40 19 21 22 18 18 21 22 23 33 34 34 34 34 34 34 34 34 34 35 27 7 86 4 0 0 0 84 0 0 
0 84 0 11 7 78 36 41 41 41 41 41 41 41 41 41 41 41 41 41 40 17 20 25 16 16 20 25 24 19 21 22 18 18 18 18 18 21 22 23 27 7 7 4 0 0 0 0 0 0 
0 0 0 11 77 7 19 21 22 18 18 21 22 18 21 22 18 18 21 22 23 47 26 26 26 26 26 26 26 17 20 25 16 16 16 16 16 20 25 24 27 5 1 3 0 0 0 0 0 0 
0 0 0 11 7 7 17 20 25 16 16 20 25 16 20 25 16 16 20 25 24 27 7 86 82 81 85 7 77 26 26 26 26 26 26 26 26 26 26 26 28 4 0 0 0 0 0 0 0 0 
84 0 0 11 82 81 26 26 26 26 26 26 26 26 26 26 26 26 26 26 26 28 7 7 83 80 7 7 7 7 5 1 1 1 1 1 1 1 1 1 1 3 0 0 0 0 0 0 0 0 
0 0 0 11 83 80 7 77 7 7 7 7 5 1 1 1 1 1 1 1 1 1 1 1 1 1 1 1 1 1 1 0 0 0 0 0 0 0 0 0 0 0 0 84 0 0 0 0 0 0 
0 0 0 2 1 1 1 1 1 1 1 1 3 0 0 0 0 0 0 0 0 0 0 0 0 0 0 0 0 0 0 0 0 0 0 84 0 0 0 0 0 0 0 0 0 0 0 0 0 0 
0 0 0 0 0 0 0 0 0 0 0 0 0 0 0 0 0 0 0 0 0 0 84 0 0 0 0 0 0 0 0 0 0 0 0 0 0 0 0 0 0 0 0 0 0 0 0 0 0 0